0 0 0 3 3 3 3 3 3 3 3 3 0 0 0 0
0 0 0 3 6 1 2 3 1 4 1 3 0 0 0 0
0 0 0 3 1 3 3 3 1 3 2 3 0 0 0 0
0 0 0 3 1 1 2 1 1 3 1 3 0 0 0 0
0 0 0 3 3 3 1 3 3 3 1 3 0 0 0 0
0 0 0 3 7 4 4 1 4 1 2 3 0 0 0 0
0 0 0 3 3 3 1 3 3 3 3 3 0 0 0 0
0 0 0 3 1 1 8 1 1 1 5 3 0 0 0 0
0 0 0 3 3 3 3 3 3 3 3 3 0 0 0 0

