0 0 0 0 0 3 3 3 3 3 0 0 0 0 0 0
0 0 0 0 0 3 6 1 2 3 0 0 0 0 0 0
0 0 0 0 0 3 1 3 1 3 0 0 0 0 0 0
0 0 0 0 0 3 1 4 1 3 0 0 0 0 0 0
0 0 0 0 0 3 1 1 1 3 0 0 0 0 0 0
0 0 0 0 0 3 3 3 1 3 0 0 0 0 0 0
0 0 0 0 0 3 7 1 1 3 0 0 0 0 0 0
0 0 0 0 0 3 1 8 1 3 0 0 0 0 0 0
0 0 0 0 0 3 3 5 3 3 0 0 0 0 0 0
