0 0 0 0 0 3 3 3 3 3 0 0 0 0 0 0
0 0 0 0 0 3 6 1 2 3 0 0 0 0 0 0
0 0 0 0 0 3 10 3 1 3 0 0 0 0 0 0
0 0 0 0 0 3 9 4 1 3 0 0 0 0 0 0
0 0 0 0 0 3 10 9 10 3 0 0 0 0 0 0
0 0 0 0 0 3 3 3 9 3 0 0 0 0 0 0
0 0 0 0 0 3 7 9 10 3 0 0 0 0 0 0
0 0 0 0 0 3 1 8 11 3 0 0 0 0 0 0
0 0 0 0 0 3 3 5 3 3 0 0 0 0 0 0
