0 0 0 0 0 0 0 0 0 0 0 0 0 0 0 0
0 0 0 0 3 3 3 3 3 3 3 0 0 0 0 0
0 0 0 0 3 6 1 3 1 5 3 0 0 0 0 0
0 0 0 3 1 1 2 1 2 8 1 3 0 0 0 0
0 0 0 3 2 1 3 3 3 4 2 3 0 0 0 0
0 0 0 3 10 2 10 7 10 2 10 3 0 0 0 0
0 0 0 0 3 9 2 9 2 9 3 0 0 0 0 0
0 0 0 0 3 3 3 3 3 3 3 0 0 0 0 0
0 0 0 0 0 0 0 0 0 0 0 0 0 0 0 0