0 0 0 0 0 0 0 3 3 3 3 3 3 0 0 0
0 0 0 0 0 0 0 3 1 1 5 1 3 0 0 0
0 0 0 0 0 0 3 3 3 3 3 8 3 3 0 0
0 0 0 0 0 0 3 1 11 11 1 1 6 3 0 0
0 0 0 0 0 0 3 11 3 11 3 1 1 3 0 0
0 0 0 0 3 3 3 1 1 4 11 11 3 3 0 0
0 0 0 0 3 7 3 11 3 11 3 1 3 0 0 0
0 0 0 0 3 1 1 1 1 1 4 1 3 0 0 0
0 0 0 0 3 3 3 3 3 3 3 3 0 0 0 0