0 0 0 0 0 0 0 3 3 3 3 0 0 0 0 0
0 0 0 0 0 0 3 3 1 5 3 3 0 0 0 0
0 0 0 0 3 3 3 1 8 2 1 3 0 0 0 0
0 0 0 0 3 6 3 9 1 2 1 3 0 0 0 0
0 0 0 0 3 1 3 1 9 1 9 3 0 0 0 0
0 0 0 0 3 4 3 2 2 2 2 3 0 0 0 0
0 0 0 0 3 9 1 9 1 1 9 3 0 0 0 0
0 0 0 0 3 3 3 3 3 3 7 3 0 0 0 0
0 0 0 0 0 0 0 0 0 3 3 3 0 0 0 0