0 0 0 0 0 3 3 3 3 3 0 0 0 0 0 0
0 0 0 0 0 3 1 6 1 3 0 0 0 0 0 0
0 0 0 0 3 3 2 2 2 3 0 0 0 0 0 0
0 0 0 0 3 1 1 1 7 3 3 0 0 0 0 0
0 0 0 0 3 3 9 2 1 1 3 3 3 0 0 0
0 0 0 0 0 3 4 3 2 2 1 1 3 0 0 0
0 0 0 0 0 3 1 1 2 1 4 3 3 0 0 0
0 0 0 0 0 3 3 3 3 8 2 1 3 0 0 0
0 0 0 0 0 0 0 0 3 1 5 3 3 0 0 0