0 0 0 0 0 0 0 3 3 3 3 0 0 0 0 0
0 0 0 0 0 0 0 3 5 1 3 3 0 0 0 0
0 0 0 0 3 3 3 3 1 8 1 3 0 0 0 0
0 0 0 0 3 1 7 3 2 2 2 3 0 0 0 0
0 0 0 0 3 4 2 1 4 2 1 3 0 0 0 0
0 0 0 0 3 1 3 4 1 1 6 3 0 0 0 0
0 0 0 0 3 10 3 3 9 3 3 3 0 0 0 0
0 0 0 0 3 9 10 9 10 3 0 0 0 0 0 0
0 0 0 0 3 3 3 3 3 3 0 0 0 0 0 0